###################
#0.......#........#
#o##.###.#.###.##o#
#.................#
#.##.#.#####.#.##.#
#....#...#...#....#
####.### #####.####
---#.#-------#.#---
####.# ##### #.####
----.--#123#--.----
####.# ##### #.####
---#.#-------#.#---
####.# ##### #.####
#........#........#
#.##.###.#.###.##.#
#o.#...........#.o#
##.#.#.#####.#.#.##
#....#...#...#....#
#.######.#.######.#
#P................#
###################
